


NO ./textures/wall_north.xpm

SO ./textures/wall_south.xpm

WE ./textures/wall_west.xpm

EA ./textures/wall_east.xpm

F 220,100,50

C 220,30,50



        1111111111111111111111111
        1000000000110000000000001
        1011000001110000000000001
        1001000000000000000000001
111111111011000001110000000000001
100000000011000001110110111111111
11110111111111011100000N10001
11111111111111111111111111111