


NO ./textures/wall_north.xpm

SO ./textures/wall_south.xpm

WE ./textures/wall_west.xpm

EA ./textures/wall_east.xpm

F 220,100,50

C 220,30,50



        1111111111111111111111111
        1000000000110000000000001
        1011000001110000000000001
        1001000000000000000000001
111111111011000001110000000000001
100000000011000001110111110111111
11110111111111011100000010001
11110111111111000001010010001
11000000110101011100000010001
10000000001000001100000010001
1000000001 100001101011111011
110000011111010111110000000001
11110111 1110101 101111011E001
11111111 1111111 11111 111111