NO ./textures/wall_north.xpm
SO ./textures/wall_south.xpm
WE ./textures/wall_west.xpm
EA ./textures/wall_east.xpm

F 220,100,50
C 220,30,50

        1111111111111111111111111
        1000000000110000000000001
        1011000001110000000000001
        1001000000040000000000001
111111111011000001110000000000001
100000000011000001110111114111111
11110111111111011100000010301
11110111111111000001010010001
11000000110101011100000010001
10000000000000001100000010301
10000000000000001101011111411
110000011101010111110003400001
11110111 1110101 101111011N001
11111111 1111111 111111111111
